11111111111111111111
10000000000000000001
00000P00C000C0000001
100000000000000E0001
11111111111111111111