11111111111111111111
10000000000000C00001
100C0000000000000001
10000000000000000001
10000P00C000C0000001
100000000000000E0001
10000000000000000001
11111111111111111111