11111111111111111111
1000000000P000000001
10000P00C000C0000001
100000000000000E0001
11111111111111111111