11111111111111111111
10000000000000000001
10000P00000000000001
100000000000000E0001
11111111111111111111