11111111111111111111
10000000000000000001
10000P00C000C0000001
10000000000000000001
11111111111111111111